{
  "name": "level_9",
  "version": "1.0.0",
  "bundle": 1,
  "difficulty" :  0,
  "levelContent": [
    [ 0, 0, 0, 0, 1, 0, 0 ],
    [ 0, 0, 0, 1, 1, 0, 0 ],
    [ 0, 0, 1, 1, 1, 1, 0 ],
    [ 0, 1, 1, 1, 1, 1, 1 ],
    [ 1, 1, 1, 1, 1, 1, 1 ],
    [ 1, 1, 1, 1, 1, 1, 1 ],
    [ 1, 1, 1, 0, 1, 1, 1 ],
    [ 1, 1, 1, 0, 1, 1, 1 ],
    [ 1, 1, 1, 1, 1, 1, 1 ],
    [ 0, 0, 0, 0, 0, 0, 0 ],
    [ 0, 0, 0, 0, 0, 0, 0 ],
    [ 0, 0, 0, 0, 0, 0, 0 ],
    [ 0, 0, 0, 0, 0, 0, 0 ],
    [ 0, 0, 0, 0, 0, 0, 0 ],
    [ 0, 0, 0, 0, 0, 0, 0 ]
  ],
  "boosterProbability": [],
  "tutorial": 1,
  "time": 60,
  "objective": [],
  "enableMultiplier": true,
  "ballAttempt": 3,
  "reward": [
    {
      "coins" :  50
    }
  ]
}